ID,Featured,Pct_of_Active_(7d)_Teams_with_App_Installed,Active_(7d)_Installed_Teams,Pct_of_Installed_Teams_Using_App,App_Active_(7d)_Teams,App_Active_(7d)_Teams_Last_Week,Net_Growth,Pct_Growth,New,Pct_New,Resurrected,Retained,Pct_Retention,Churned,Pct_Churn,Stale
1,no,0.26,167239,0.30,49359,45135,4224,0.09,6839,0.15,14117,28403,0.63,16732,0.37,112999
2,no,0.23,151886,0.43,65718,61338,4380,0.07,4048,0.07,13135,48535,0.79,12803,0.21,77256
3,no,0.16,105937,0.56,59309,58475,834,0.01,1998,0.03,5098,52213,0.89,6262,0.11,34088
4,no,0.15,99137,0.15,14681,14445,236,0.02,447,0.03,2337,11897,0.82,2548,0.18,16424
5,no,0.15,95338,0.14,13384,12731,653,0.05,1757,0.14,4091,7536,0.59,5195,0.41,30987
6,no,0.11,71896,0.32,23286,23682,-396,-0.02,1127,0.05,3137,19022,0.80,4660,0.20,37545
7,no,0.10,65973,0.14,8894,8544,350,0.04,890,0.10,2351,5653,0.66,2891,0.34,29311
8,no,0.10,63397,0.51,32537,31926,611,0.02,1120,0.04,3184,28233,0.88,3693,0.12,25363
9,yes,0.08,49277,0.41,20335,20118,217,0.01,3217,0.16,2332,14786,0.74,5332,0.27,34376
10,no,0.07,48101,0.99,47419,40815,6604,0.16,928,0.02,8292,38199,0.94,2616,0.06,11166
11,no,0.07,45211,0.31,14146,13786,360,0.03,917,0.07,1114,12115,0.88,1671,0.12,15965
12,no,0.07,44414,0.79,35276,34198,1078,0.03,1283,0.04,2366,31627,0.93,2571,0.08,15055
13,no,0.06,39572,0.39,15440,14904,536,0.04,890,0.06,1780,12770,0.86,2134,0.14,22149
14,yes,0.06,39297,0.13,5214,4888,326,0.07,1663,0.34,2005,1546,0.32,3342,0.68,37150
15,no,0.06,36202,0.46,16584,16567,17,0.00,519,0.03,1992,14073,0.85,2494,0.15,13344
16,no,0.05,34630,0.14,4787,4486,301,0.07,514,0.12,1058,3215,0.72,1271,0.28,13797
17,no,0.05,34071,0.03,1118,918,200,0.22,497,0.54,449,172,0.19,746,0.81,14571
18,no,0.05,32307,0.41,13352,13188,164,0.01,579,0.04,810,11963,0.91,1225,0.09,10337
19,no,0.05,30668,0.55,16971,16884,87,0.01,320,0.02,841,15810,0.94,1074,0.06,5900
20,yes,0.04,26212,0.05,1268,1242,26,0.02,831,0.67,284,153,0.12,1089,0.88,23491
21,yes,0.04,24576,0.13,3301,3343,-42,-0.01,821,0.25,881,1599,0.48,1744,0.52,25412
22,no,0.04,22922,0.59,13502,13432,70,0.01,307,0.02,885,12310,0.92,1122,0.08,6133
23,no,0.03,20196,0.06,1173,1195,-22,-0.02,44,0.04,100,1029,0.86,166,0.14,2422
24,no,0.03,19438,0.12,2416,2100,316,0.15,326,0.16,715,1375,0.66,725,0.35,8854
25,no,0.03,18481,0.16,2876,2797,79,0.03,198,0.07,359,2319,0.83,478,0.17,4956
26,yes,0.03,18095,0.32,5862,5796,66,0.01,183,0.03,277,5402,0.93,394,0.07,5010
27,no,0.03,16693,0.05,766,684,82,0.12,181,0.27,336,249,0.36,435,0.64,6310
28,no,0.02,14587,0.17,2544,2525,19,0.01,296,0.12,549,1699,0.67,826,0.33,8443
29,no,0.02,12889,0.41,5306,4928,378,0.08,497,0.10,990,3819,0.78,1109,0.23,7017
30,no,0.02,11920,0.41,4852,4778,74,0.02,74,0.02,797,3981,0.83,797,0.17,3265
31,no,0.02,11672,0.52,6115,5941,174,0.03,168,0.03,504,5443,0.92,498,0.08,3683
32,no,0.02,11502,0.45,5200,4834,366,0.08,388,0.08,980,3832,0.79,1002,0.21,8562
33,yes,0.02,10851,0.10,1122,1027,95,0.09,188,0.18,318,616,0.60,411,0.40,5758
34,yes,0.02,10573,0.85,9017,8849,168,0.02,351,0.04,384,8282,0.94,567,0.06,4147
35,no,0.02,10495,0.11,1165,1127,38,0.03,185,0.16,339,641,0.57,486,0.43,2654
36,no,0.02,10153,0.50,5062,5003,59,0.01,103,0.02,235,4724,0.94,279,0.06,2763
37,no,0.02,10094,0.38,3801,3765,36,0.01,104,0.03,723,2974,0.79,791,0.21,3500
38,no,0.01,9159,0.46,4230,3369,861,0.26,670,0.20,1131,2429,0.72,940,0.28,8928
39,yes,0.01,8359,1.02,8523,8511,12,0.00,251,0.03,360,7912,0.93,599,0.07,4320
40,no,0.01,7029,0.62,4382,4386,-4,0.00,98,0.02,330,3954,0.90,432,0.10,1999
41,no,0.01,6620,0.36,2400,2289,111,0.05,49,0.02,574,1777,0.78,512,0.22,1662
42,no,0.01,6569,0.39,2554,2545,9,0.00,73,0.03,385,2096,0.82,449,0.18,1869
43,yes,0.01,6476,0.83,5367,4765,602,0.13,118,0.03,955,4294,0.90,471,0.10,4174
44,no,0.01,6137,0.43,2638,2672,-34,-0.01,95,0.04,281,2262,0.85,410,0.15,2045
45,no,0.01,6097,0.51,3112,3029,83,0.03,148,0.05,264,2700,0.89,329,0.11,1673
46,no,0.01,5884,0.40,2343,2391,-48,-0.02,51,0.02,133,2159,0.90,232,0.10,1731
47,yes,0.01,5760,0.46,2635,2676,-41,-0.02,176,0.07,265,2194,0.82,482,0.18,4150
48,no,0.01,5699,0.15,842,788,54,0.07,203,0.26,303,336,0.43,452,0.57,4820
49,no,0.01,5664,0.43,2433,2423,10,0.00,44,0.02,385,2004,0.83,419,0.17,1744
50,yes,0.01,5158,0.40,2076,1950,126,0.07,187,0.10,465,1424,0.73,526,0.27,2938
51,yes,0.01,4920,1.00,4922,4692,230,0.05,308,0.07,384,4230,0.90,462,0.10,2811
52,no,0.01,4865,0.12,591,548,43,0.08,96,0.18,171,324,0.59,224,0.41,2163
53,yes,0.01,4700,0.68,3188,3116,72,0.02,45,0.01,264,2879,0.92,237,0.08,845
54,no,0.01,4531,0.22,982,891,91,0.10,96,0.11,180,706,0.79,185,0.21,1319
55,no,0.01,4451,0.76,3387,3315,72,0.02,96,0.03,179,3112,0.94,203,0.06,1259
56,no,0.01,4420,0.61,2707,2633,74,0.03,71,0.03,236,2400,0.91,233,0.09,855
57,no,0.01,4192,0.48,2013,2045,-32,-0.02,46,0.02,204,1763,0.86,282,0.14,1509
58,no,0.01,4072,0.38,1564,1563,1,0.00,33,0.02,89,1442,0.92,121,0.08,486
59,no,0.01,4007,0.10,405,347,58,0.17,253,0.73,93,59,0.17,288,0.83,3038
60,no,0.01,3931,0.29,1127,1907,-780,-0.41,126,0.07,47,954,0.50,953,0.50,2705
61,yes,0.01,3901,1.02,3986,3604,382,0.11,618,0.17,188,3180,0.88,424,0.12,1259
62,yes,0.01,3841,0.34,1306,1256,50,0.04,80,0.06,283,943,0.75,313,0.25,2334
63,no,0.01,3711,0.54,1988,1914,74,0.04,10,0.01,303,1675,0.88,239,0.13,1635
64,no,0.01,3667,0.81,2969,2823,146,0.05,162,0.06,185,2622,0.93,201,0.07,2905
65,no,0.01,3535,0.36,1278,1315,-37,-0.03,24,0.02,215,1039,0.79,276,0.21,2066
66,yes,0.00,3193,0.99,3169,3154,15,0.01,80,0.03,140,2949,0.94,205,0.07,1370
67,no,0.00,3207,0.60,1932,2790,-858,-0.31,131,0.05,126,1675,0.60,1115,0.40,1866
68,no,0.00,3200,0.40,1271,1301,-30,-0.02,0,0.00,62,1209,0.93,92,0.07,403
69,no,0.00,3195,0.56,1795,1722,73,0.04,50,0.03,185,1560,0.91,162,0.09,716
70,no,0.00,3095,0.17,519,488,31,0.06,132,0.27,173,214,0.44,274,0.56,2141
71,no,0.00,3114,1.02,3175,2821,354,0.13,185,0.07,564,2426,0.86,395,0.14,1503
72,no,0.00,3009,0.65,1940,1862,78,0.04,50,0.03,226,1664,0.89,198,0.11,853
73,no,0.00,2977,0.12,356,348,8,0.02,116,0.33,112,128,0.37,220,0.63,2512
74,no,0.00,2975,0.35,1025,919,106,0.12,140,0.15,179,706,0.77,213,0.23,1812
75,no,0.00,2906,0.47,1352,1353,-1,0.00,0,0.00,146,1206,0.89,147,0.11,910
76,yes,0.00,2852,0.09,256,263,-7,-0.03,31,0.12,83,142,0.54,121,0.46,2257
77,no,0.00,2690,0.49,1308,1256,52,0.04,57,0.05,111,1140,0.91,116,0.09,1214
78,yes,0.00,2665,0.10,257,230,27,0.12,70,0.30,114,73,0.32,157,0.68,2503
79,no,0.00,2650,0.83,2190,2123,67,0.03,106,0.05,115,1969,0.93,154,0.07,1165
80,no,0.00,2484,0.34,844,755,89,0.12,151,0.20,168,525,0.70,230,0.31,1250
81,no,0.00,2448,0.20,493,490,3,0.01,8,0.02,33,452,0.92,38,0.08,135
82,no,0.00,2418,0.38,914,921,-7,-0.01,110,0.12,187,617,0.67,304,0.33,1621
83,no,0.00,2312,0.11,262,218,44,0.20,121,0.56,45,96,0.44,122,0.56,1342
84,no,0.00,2345,0.15,340,343,-3,-0.01,121,0.35,148,71,0.21,272,0.79,1646
85,no,0.00,2286,0.19,441,373,68,0.18,180,0.48,139,122,0.33,251,0.67,2233
86,no,0.00,2294,0.61,1393,1369,24,0.02,22,0.02,58,1313,0.96,56,0.04,487
87,no,0.00,2198,0.26,568,561,7,0.01,75,0.13,153,340,0.61,221,0.39,1091
88,no,0.00,2157,0.63,1358,1338,20,0.02,33,0.03,149,1176,0.88,162,0.12,1145
89,no,0.00,2090,0.19,398,384,14,0.04,113,0.29,89,196,0.51,188,0.49,1292
90,no,0.00,2056,0.69,1410,1362,48,0.04,74,0.05,91,1245,0.91,117,0.09,1139
91,no,0.00,2050,0.60,1225,1185,40,0.03,26,0.02,117,1082,0.91,103,0.09,460
92,no,0.00,2032,0.48,965,929,36,0.04,11,0.01,97,857,0.92,72,0.08,372
93,yes,0.00,1876,0.53,986,1000,-14,-0.01,108,0.11,47,831,0.83,169,0.17,2566
94,no,0.00,1904,0.61,1160,1132,28,0.03,43,0.04,107,1010,0.89,122,0.11,885
95,no,0.00,1879,0.37,685,677,8,0.01,27,0.04,30,628,0.93,49,0.07,1144
96,yes,0.00,1793,0.15,269,288,-19,-0.07,7,0.02,13,249,0.87,39,0.14,194
97,no,0.00,1813,0.15,269,227,42,0.19,99,0.44,90,80,0.35,147,0.65,1039
98,yes,0.00,1840,0.85,1568,1490,78,0.05,137,0.09,64,1367,0.92,123,0.08,1117
99,no,0.00,1771,1.01,1784,1772,12,0.01,112,0.06,64,1608,0.91,164,0.09,1113
100,yes,0.00,1741,0.61,1059,1051,8,0.01,57,0.05,93,909,0.87,142,0.14,1479
101,no,0.00,1718,1.02,1745,1718,27,0.02,79,0.05,48,1618,0.94,100,0.06,554
102,no,0.00,1672,0.98,1633,1595,38,0.02,69,0.04,43,1521,0.95,74,0.05,834
103,no,0.00,1670,0.46,762,690,72,0.10,102,0.15,127,533,0.77,157,0.23,1758
104,no,0.00,1678,0.98,1645,1565,80,0.05,112,0.07,106,1427,0.91,138,0.09,330
105,no,0.00,1709,0.21,361,335,26,0.08,12,0.04,104,245,0.73,90,0.27,448
106,yes,0.00,1619,0.33,535,517,18,0.04,78,0.15,95,362,0.70,155,0.30,989
107,yes,0.00,1634,0.75,1231,1156,75,0.07,80,0.07,107,1044,0.90,112,0.10,234
108,no,0.00,1545,0.78,1200,1139,61,0.05,40,0.04,100,1060,0.93,79,0.07,513
109,no,0.00,1546,0.73,1127,1118,9,0.01,23,0.02,8,1096,0.98,22,0.02,124
110,no,0.00,1589,0.49,778,775,3,0.00,18,0.02,53,707,0.91,68,0.09,852
111,no,0.00,1522,0.16,246,236,10,0.04,108,0.46,67,71,0.30,165,0.70,1182
112,no,0.00,1458,0.32,460,480,-20,-0.04,35,0.07,16,409,0.85,71,0.15,1480
113,no,0.00,1458,0.82,1192,1188,4,0.00,35,0.03,98,1059,0.89,129,0.11,1201
114,no,0.00,1414,0.47,664,658,6,0.01,19,0.03,40,605,0.92,53,0.08,515
115,no,0.00,1359,0.95,1291,1304,-13,-0.01,41,0.03,80,1170,0.90,134,0.10,546
116,yes,0.00,1392,0.89,1236,1486,-250,-0.17,23,0.02,78,1135,0.76,351,0.24,559
117,no,0.00,1275,0.44,560,502,58,0.12,85,0.17,158,317,0.63,185,0.37,511
118,no,0.00,1307,0.95,1239,1212,27,0.02,33,0.03,49,1157,0.96,55,0.05,631
119,yes,0.00,1300,1.01,1318,1212,106,0.09,186,0.15,65,1067,0.88,145,0.12,225
120,yes,0.00,1310,0.47,620,651,-31,-0.05,87,0.13,45,488,0.75,163,0.25,1292
121,no,0.00,1271,0.26,330,355,-25,-0.07,5,0.01,30,295,0.83,60,0.17,345
122,no,0.00,1273,0.49,623,620,3,0.01,6,0.01,46,571,0.92,49,0.08,241
123,yes,0.00,1227,0.96,1176,1190,-14,-0.01,0,0.00,58,1118,0.94,72,0.06,970
124,no,0.00,1215,0.40,481,441,40,0.09,19,0.04,105,357,0.81,84,0.19,468
125,no,0.00,1264,0.93,1171,1170,1,0.00,32,0.03,55,1084,0.93,86,0.07,573
126,no,0.00,1181,0.57,674,686,-12,-0.02,30,0.04,37,607,0.89,79,0.12,609
127,no,0.00,1169,0.65,755,769,-14,-0.02,21,0.03,56,678,0.88,91,0.12,426
128,no,0.00,1198,0.45,543,565,-22,-0.04,24,0.04,104,415,0.74,150,0.27,383
129,yes,0.00,1158,0.44,509,500,9,0.02,28,0.06,12,469,0.94,31,0.06,738
130,no,0.00,1132,0.97,1102,1102,0,0.00,72,0.07,51,979,0.89,123,0.11,828
131,yes,0.00,1126,0.77,866,865,1,0.00,49,0.06,68,749,0.87,116,0.13,986
132,no,0.00,1070,1.02,1087,1053,34,0.03,73,0.07,30,984,0.93,69,0.07,348
133,no,0.00,1022,0.69,709,665,44,0.07,56,0.08,5,648,0.97,17,0.03,73
134,no,0.00,1033,0.55,567,561,6,0.01,3,0.01,63,501,0.89,60,0.11,317
135,no,0.00,1019,1.01,1032,977,55,0.06,85,0.09,60,887,0.91,90,0.09,202
136,no,0.00,949,0.38,357,329,28,0.09,47,0.14,49,261,0.79,68,0.21,221
137,no,0.00,985,0.29,282,264,18,0.07,37,0.14,121,124,0.47,140,0.53,502
138,no,0.00,946,0.42,393,299,94,0.31,174,0.58,46,173,0.58,126,0.42,296
139,no,0.00,972,0.99,966,879,87,0.10,41,0.05,108,817,0.93,62,0.07,342
140,no,0.00,947,0.57,535,518,17,0.03,14,0.03,49,472,0.91,46,0.09,206
141,no,0.00,921,0.43,391,377,14,0.04,24,0.06,45,322,0.85,55,0.15,400
142,no,0.00,912,0.26,239,208,31,0.15,65,0.31,22,152,0.73,56,0.27,508
143,no,0.00,911,0.43,391,394,-3,-0.01,8,0.02,13,370,0.94,24,0.06,339
144,no,0.00,888,0.25,225,204,21,0.10,48,0.24,44,133,0.65,71,0.35,540
145,no,0.00,873,0.76,663,647,16,0.03,56,0.09,22,585,0.90,62,0.10,503
146,no,0.00,755,0.54,404,389,15,0.04,74,0.19,56,274,0.70,115,0.30,251
147,no,0.00,760,0.57,431,434,-3,-0.01,10,0.02,33,388,0.89,46,0.11,162
148,no,0.00,802,0.43,346,337,9,0.03,44,0.13,42,260,0.77,77,0.23,303
149,no,0.00,788,0.53,420,424,-4,-0.01,0,0.00,33,387,0.91,37,0.09,166
150,yes,0.00,808,0.27,221,219,2,0.01,20,0.09,16,185,0.85,34,0.16,422
151,no,0.00,761,0.70,534,525,9,0.02,4,0.01,40,490,0.93,35,0.07,100
152,no,0.00,708,0.59,419,393,26,0.07,19,0.05,40,360,0.92,33,0.08,317
153,no,0.00,702,0.39,272,223,49,0.22,48,0.22,28,196,0.88,27,0.12,772
154,yes,0.00,738,0.73,540,530,10,0.02,11,0.02,17,512,0.97,18,0.03,213
155,no,0.00,726,0.80,577,401,176,0.44,79,0.20,171,327,0.82,74,0.19,427
156,no,0.00,728,0.38,278,259,19,0.07,42,0.16,39,197,0.76,62,0.24,213
157,yes,0.00,737,0.35,257,244,13,0.05,15,0.06,47,195,0.80,49,0.20,237
158,no,0.00,658,0.36,234,214,20,0.09,22,0.10,35,177,0.83,37,0.17,257
159,yes,0.00,657,1.03,678,669,9,0.01,36,0.05,63,579,0.87,90,0.14,473
160,no,0.00,645,0.70,449,436,13,0.03,31,0.07,48,370,0.85,66,0.15,155
161,no,0.00,671,0.69,461,474,-13,-0.03,10,0.02,11,440,0.93,34,0.07,383
162,no,0.00,572,0.99,568,571,-3,-0.01,19,0.03,16,533,0.93,38,0.07,147
163,no,0.00,554,0.37,207,200,7,0.04,17,0.09,27,163,0.82,37,0.19,200
164,no,0.00,611,0.36,217,216,1,0.01,15,0.07,26,176,0.82,40,0.19,258
165,no,0.00,568,0.60,340,327,13,0.04,14,0.04,35,291,0.89,36,0.11,185
166,yes,0.00,578,0.71,408,414,-6,-0.01,10,0.02,29,369,0.89,45,0.11,180
167,no,0.00,552,1.01,560,558,2,0.00,16,0.03,19,525,0.94,33,0.06,193
168,no,0.00,525,0.97,508,477,31,0.07,62,0.13,18,428,0.90,49,0.10,171
169,no,0.00,528,0.44,231,222,9,0.04,12,0.05,37,182,0.82,40,0.18,162
170,no,0.00,518,1.01,525,523,2,0.00,33,0.06,22,470,0.90,53,0.10,165
171,no,0.00,463,0.76,353,357,-4,-0.01,8,0.02,6,339,0.95,18,0.05,136
172,no,0.00,434,0.67,290,389,-99,-0.25,37,0.10,12,241,0.62,148,0.38,98
173,no,0.00,487,0.81,392,401,-9,-0.02,20,0.05,16,356,0.89,45,0.11,171
174,no,0.00,478,0.81,386,323,63,0.20,35,0.11,53,298,0.92,25,0.08,138
175,no,0.00,478,1.02,488,460,28,0.06,33,0.07,8,447,0.97,13,0.03,80
176,yes,0.00,437,0.56,244,237,7,0.03,10,0.04,23,211,0.89,26,0.11,144
177,no,0.00,471,1.13,530,277,253,0.91,313,1.13,1,216,0.78,61,0.22,13
178,no,0.00,375,1.02,382,369,13,0.04,33,0.09,8,341,0.92,28,0.08,43
179,no,0.00,405,0.66,267,186,81,0.44,15,0.08,78,174,0.94,12,0.07,153
180,no,0.00,396,1.01,400,383,17,0.04,22,0.06,17,361,0.94,22,0.06,92
181,no,0.00,346,1.02,353,228,125,0.55,125,0.55,31,197,0.86,31,0.14,56
182,no,0.00,338,0.60,201,188,13,0.07,7,0.04,30,164,0.87,24,0.13,63
183,no,0.00,342,1.01,344,341,3,0.01,7,0.02,6,331,0.97,10,0.03,18
184,no,0.00,310,0.96,298,309,-11,-0.04,11,0.04,8,279,0.90,30,0.10,178
185,no,0.00,306,1.02,311,317,-6,-0.02,9,0.03,4,298,0.94,19,0.06,101
186,no,0.00,352,0.98,344,49,295,6.02,18,0.37,294,32,0.65,17,0.35,201
187,no,0.00,325,1.04,337,322,15,0.05,22,0.07,29,286,0.89,36,0.11,256
188,no,0.00,316,0.92,291,258,33,0.13,63,0.24,17,211,0.82,47,0.18,159
189,no,0.00,309,0.91,281,235,46,0.20,35,0.15,30,216,0.92,19,0.08,72
190,no,0.00,302,0.88,267,265,2,0.01,13,0.05,17,237,0.89,28,0.11,169
191,no,0.00,307,1.14,351,319,32,0.10,12,0.04,52,287,0.90,32,0.10,64
192,no,0.00,299,0.98,292,296,-4,-0.01,7,0.02,12,273,0.92,23,0.08,55
193,no,0.00,259,1.07,276,280,-4,-0.01,10,0.04,13,253,0.90,27,0.10,79
194,no,0.00,269,1.12,300,310,-10,-0.03,29,0.09,8,263,0.85,47,0.15,411
195,no,0.00,287,0.96,276,258,18,0.07,24,0.09,7,245,0.95,13,0.05,14
196,no,0.00,254,0.99,251,269,-18,-0.07,7,0.03,22,222,0.83,47,0.18,132
197,no,0.00,285,1.01,288,241,47,0.20,7,0.03,57,224,0.93,17,0.07,60
198,no,0.00,258,1.00,258,243,15,0.06,22,0.09,9,227,0.93,16,0.07,116
199,no,0.00,235,1.03,241,231,10,0.04,17,0.07,17,207,0.90,24,0.10,57
200,no,0.00,262,1.01,264,249,15,0.06,8,0.03,37,219,0.88,30,0.12,120
201,no,0.00,281,0.99,278,284,-6,-0.02,1,0.00,8,269,0.95,15,0.05,36
202,no,0.00,240,1.03,246,241,5,0.02,8,0.03,10,228,0.95,13,0.05,62
203,no,0.00,255,0.99,253,232,21,0.09,39,0.17,12,202,0.87,30,0.13,63
204,yes,0.00,241,1.07,257,256,1,0.00,16,0.06,15,226,0.88,30,0.12,127
205,yes,0.00,258,1.02,264,264,0,0.00,20,0.08,25,219,0.83,45,0.17,92
206,no,0.00,256,0.81,208,200,8,0.04,9,0.05,20,179,0.90,21,0.11,89
207,no,0.00,207,0.97,201,185,16,0.09,23,0.12,12,166,0.90,19,0.10,77
208,no,0.00,219,0.98,215,215,0,0.00,2,0.01,7,206,0.96,9,0.04,86
209,no,0.00,209,0.99,207,209,-2,-0.01,1,0.01,1,205,0.98,4,0.02,45
210,no,0.00,201,1.02,204,18,186,10.33,186,10.33,0,18,1.00,0,0.00,5
211,no,0.00,222,1.05,232,17,215,12.65,216,12.71,0,16,0.94,1,0.06,0
